R  900 550
F  49,55,37
C  46,40,255
NO ./textures/mnorth_texture.xpm
SO ./textures/msouth_texture.xpm
WE ./textures/mwest_texture.xpm
EA ./textures/meast_texture.xpm
S  ./textures/saturno.xpm
        1111111111111111111111111
        1000000000110000000000001
        1011000001110000002000001
        1001000000000000000000001
111111111011000001110000000000001
100000000011000001110111111111111
11110111111111011100000000001
11110111111111011101010000001
11000000110101011100000000001
10002000000000001100000000001
10000000000000001101010000001
11000001110101011111011110N0111
11110111 1110101 101111010001
11111111 1111111 111111111111